.......................
.#####################.
.#...................#.
.#.........*.........#.
.#...................#.
.#...................#.
.#...................#.
.########.....########.
.#...................#.
.#...................#.
.#...................#.
.#.........|.........#.
.#...................#.
.#####################.
.......................