...#...#...#...#...#...
...P.......#.+.#.D.#.*.
...#...#...#...#...#...
#.###Q###.###R###R###d#
...#...#...#...#...#...
...#...#.+.#...S...c.+.
...#...#...#...#...#...
#Q#####################
...#...#...#...#...#...
.......N.....A.#...a.+.
...#...#...#...#...#...
#O###############.###O#
...#...#...#...#...#...
.|.N...S.C.....b...P.B.
...#...#...#...#...#...