......................
....#####.....#####....
....#...#.....#...#....
....#.N.#.....#.*.#....
....#...#.....#...#....
....#...#.....#...#....
....#...#.....#...#....
....#...#.....#...#....
....#...#.....#...#....
....#...#.....#...#....
....#...#.....#...#....
....#.|.#.....#.N.#....
....#...#.....#...#....
....#####.....#####....
.......................