.......................
.#####################.
.#.......#...#.......#.
.#.......#.*.#.......#.
.#.......#...#.......#.
.#.......#aaa#.......#.
.#...................#.
.#....A....+....A....#.
.#...................#.
.#...................#.
.#...................#.
.#.........|.........#.
.#...................#.
.#####################.
.......................