........c..#####.......
.....N..#+##*cba.....C.
...........#####.......
.....+.....#...........
...........#...........
.....O.....#.........B.
...........#...........
################aaa####
...........#...........
.....O.....#...........
...........#...........
...........#...........
...........#...........
.A.........#.+...N...|.
...........#...........