..........#*#..........
.B........#.#......A.|.
.+.........N.........U.
#####T#####.#######b###
.........O#.#O.........
#####b#####.###########
.........P#.#P........V
###########.###########
X........Q#.#Q.........
###########.#####.#####
Y........R#.#R.........
###########.###########
V........S#.#S.........
#####T#####.#####b#####
U...+....X#.a.........Y