...........#...........
.|.........#...........
...........#...........
...........#...........
...........#...........
...........#...........
..........Q#Q..........
...........#...........
...........#######c####
.....+....P#PC#.......#
...........#######b####
.....+....O#OB#.......#
...........#######a####
.....+....N#NA#...*...#
...........############