.....#############.....
.....#...#...#...#.....
.....#.+.#.*.#.+.#.....
.....#...#ccc#...#.....
.....#...#bbb#...#.....
.....#aaa#aaa#ccc#.....
.......................
.......................
.......................
.........A.B.C.........
.......................
...........+...........
.......................
...........|...........
.......................